"Zip Code Tabulation Area","FIPS Code","Formatted FIPS","Number of jobs at firms with fewer than 500 employees in 2016."
"10314","10314","=""10314""","12680"
"11234","11234","=""11234""","10464"
"10312","10312","=""10312""","4868"
"10306","10306","=""10306""","6573"
"11430","11430","=""11430""","4117"
"10309","10309","=""10309""","5459"
"10305","10305","=""10305""","5400"
"10304","10304","=""10304""","4113"
"11385","11385","=""11385""","10636"
"11236","11236","=""11236""","7030"
"10301","10301","=""10301""","4623"
"10464","10464","=""10464""","1357"
"11208","11208","=""11208""","6425"
"10465","10465","=""10465""","4341"
"11434","11434","=""11434""","7257"
"10303","10303","=""10303""","3566"
"11413","11413","=""11413""","4078"
"11357","11357","=""11357""","6432"
"11691","11691","=""11691""","5628"
"11101","11101","=""11101""","39779"
"11368","11368","=""11368""","7727"
"11207","11207","=""11207""","9253"
"11378","11378","=""11378""","13630"
"10471","10471","=""10471""","4257"
"11697","11697","=""11697""","359"
"11367","11367","=""11367""","3311"
"11362","11362","=""11362""","2403"
"11377","11377","=""11377""","12275"
"11365","11365","=""11365""","5109"
"10469","10469","=""10469""","4786"
"11364","11364","=""11364""","2219"
"11235","11235","=""11235""","13389"
"10461","10461","=""10461""","7889"
"11414","11414","=""11414""","2775"
"11211","11211","=""11211""","29364"
"10467","10467","=""10467""","5675"
"11229","11229","=""11229""","10186"
"11354","11354","=""11354""","19300"
"11215","11215","=""11215""","14563"
"11214","11214","=""11214""","9330"
"11432","11432","=""11432""","8946"
"10473","10473","=""10473""","3733"
"11203","11203","=""11203""","5353"
"11209","11209","=""11209""","10227"
"11379","11379","=""11379""","3667"
"11420","11420","=""11420""","2152"
"11223","11223","=""11223""","11525"
"11422","11422","=""11422""","1865"
"10466","10466","=""10466""","4541"
"11375","11375","=""11375""","11177"
"10308","10308","=""10308""","2136"
"10307","10307","=""10307""","1286"
"11358","11358","=""11358""","5243"
"10475","10475","=""10475""","3235"
"11230","11230","=""11230""","12613"
"10310","10310","=""10310""","3674"
"11361","11361","=""11361""","5346"
"11220","11220","=""11220""","16472"
"11355","11355","=""11355""","10864"
"11105","11105","=""11105""","6949"
"11412","11412","=""11412""","1432"
"11210","11210","=""11210""","6540"
"11418","11418","=""11418""","6114"
"11222","11222","=""11222""","12451"
"11224","11224","=""11224""","5824"
"10463","10463","=""10463""","7306"
"11204","11204","=""11204""","10194"
"11427","11427","=""11427""","1800"
"11356","11356","=""11356""","5743"
"11433","11433","=""11433""","3580"
"11212","11212","=""11212""","4005"
"10474","10474","=""10474""","11659"
"11435","11435","=""11435""","5518"
"11373","11373","=""11373""","8038"
"11370","11370","=""11370""","2719"
"10462","10462","=""10462""","6403"
"11219","11219","=""11219""","22332"
"11228","11228","=""11228""","4214"
"11231","11231","=""11231""","10262"
"10470","10470","=""10470""","2893"
"11206","11206","=""11206""","10967"
"10035","10035","=""10035""","5912"
"11218","11218","=""11218""","10605"
"11201","11201","=""11201""","26491"
"11423","11423","=""11423""","2462"
"11360","11360","=""11360""","1628"
"11221","11221","=""11221""","3855"
"11426","11426","=""11426""","1292"
"11233","11233","=""11233""","3738"
"11694","11694","=""11694""","2274"
"10460","10460","=""10460""","2997"
"11429","11429","=""11429""","1867"
"11421","11421","=""11421""","1855"
"11226","11226","=""11226""","6178"
"11232","11232","=""11232""","11962"
"10302","10302","=""10302""","2683"
"11411","11411","=""11411""","758"
"11419","11419","=""11419""","2766"
"11417","11417","=""11417""","2137"
"11238","11238","=""11238""","6762"
"10034","10034","=""10034""","3202"
"11371","11371","=""11371""","273"
"11366","11366","=""11366""","2017"
"10468","10468","=""10468""","4080"
"11369","11369","=""11369""","2994"
"11213","11213","=""11213""","3977"
"11692","11692","=""11692""","1578"
"10457","10457","=""10457""","5990"
"10472","10472","=""10472""","2928"
"10454","10454","=""10454""","6134"
"10451","10451","=""10451""","6879"
"10456","10456","=""10456""","4912"
"10458","10458","=""10458""","5733"
"11237","11237","=""11237""","9254"
"10452","10452","=""10452""","4429"
"11693","11693","=""11693""","1311"
"11004","11004","=""11004""","1143"
"11205","11205","=""11205""","9863"
"11374","11374","=""11374""","5008"
"11216","11216","=""11216""","4235"
"10453","10453","=""10453""","3471"
"11225","11225","=""11225""","3597"
"10002","10002","=""10002""","17615"
"11363","11363","=""11363""","712"
"10027","10027","=""10027""","9510"
"11106","11106","=""11106""","8540"
"10024","10024","=""10024""","14473"
"11428","11428","=""11428""","1609"
"10459","10459","=""10459""","3662"
"10029","10029","=""10029""","7732"
"11436","11436","=""11436""","1064"
"11102","11102","=""11102""","5162"
"10025","10025","=""10025""","12507"
"11217","11217","=""11217""","10539"
"11372","11372","=""11372""","6796"
"10455","10455","=""10455""","4853"
"11103","11103","=""11103""","6499"
"10019","10019","=""10019""","57184"
"10011","10011","=""10011""","39352"
"11416","11416","=""11416""","3030"
"10032","10032","=""10032""","5308"
"10031","10031","=""10031""","4111"
"11239","11239","=""11239""","1270"
"10009","10009","=""10009""","6776"
"10001","10001","=""10001""","74661"
"10033","10033","=""10033""","4775"
"10003","10003","=""10003""","34544"
"11415","11415","=""11415""","2906"
"10014","10014","=""10014""","23123"
"10013","10013","=""10013""","43742"
"10004","10004","=""10004""","21197"
"10016","10016","=""10016""","54524"
"10023","10023","=""10023""","17484"
"10128","10128","=""10128""","13469"
"10036","10036","=""10036""","53332"
"10039","10039","=""10039""","721"
"10022","10022","=""10022""","55473"
"11104","11104","=""11104""","2408"
"10040","10040","=""10040""","2638"
"10010","10010","=""10010""","29845"
"10021","10021","=""10021""","15197"
"10065","10065","=""10065""","16661"
"10026","10026","=""10026""","2864"
"10012","10012","=""10012""","28644"
"10018","10018","=""10018""","76947"
"10017","10017","=""10017""","50518"
"10028","10028","=""10028""","11374"
"10038","10038","=""10038""","16644"
"10030","10030","=""10030""","2107"
"10037","10037","=""10037""","1224"
"11359","11359","=""11359""","2"
"10044","10044","=""10044""","790"
"10075","10075","=""10075""","8170"
"11005","11005","=""11005""","215"
"10007","10007","=""10007""","12615"
"10280","10280","=""10280""","2149"
"10069","10069","=""10069""","494"
"10006","10006","=""10006""","8261"
"10282","10282","=""10282""","1170"
"10005","10005","=""10005""","15699"
"11109","11109","=""11109""","756"
"10311","10311","=""10311""","102"
"11425","11425","=""11425""","10"
"11451","11451","=""11451""","16"
"11424","11424","=""11424""","126"
"10020","10020","=""10020""","3790"
"10199","10199","=""10199""","17"
"10119","10119","=""10119""","2787"
"10278","10278","=""10278""","82"
"10162","10162","=""10162""","251"
"10110","10110","=""10110""","3274"
"10170","10170","=""10170""","2540"
"10103","10103","=""10103""","1990"
"10112","10112","=""10112""","1049"
"10174","10174","=""10174""","1856"
"10168","10168","=""10168""","2765"
"10165","10165","=""10165""","2973"
"10171","10171","=""10171""","1033"
"10152","10152","=""10152""","1067"
"10172","10172","=""10172""","904"
"10167","10167","=""10167""","1999"
"10154","10154","=""10154""","739"
"11351","11351","=""11351""","13"
"10173","10173","=""10173""","2185"
"10153","10153","=""10153""","1438"
"10279","10279","=""10279""","1472"
"10169","10169","=""10169""","2408"
"10111","10111","=""10111""","1654"
"10271","10271","=""10271""","2839"
"10115","10115","=""10115""","1583"
"10177","10177","=""10177""","843"

"Location: New York (City, 2010)"

"Indicator source: LEHD"
"http://www.policymap.com/our-data-directory.html#Census:%20Longitudinal%20Employer%20-%20Household%20Dynamics"

"When using PolicyMap data in your work, please consult the Terms of Use and the instructions for Citing Us:"
"https://www.policymap.com/terms/"
"https://www.policymap.com/citing/"